2 13 17
#################
#******   ******#
# #*# #*#*# #*#*#
#***   *#*   ***#
#*#*# #*# # #*# #
#*******#  *****#
#p#*#*#*#*#*### #
# b*****#***   r#
# #*# #*#*#*# #*#
#f******#*******#
#*# #*#*# #*#*# #
#******    *****#
#################

Meta data:
(Number or Level) (Rows) (Columns)

Info Tiles:
# - Wall
* - Brick

Powerups:
b - Powerup Bombs
f - Powerup Flames
s - Powerup Speed