3 13 17
#################
#              r#
#  ##############
#     ******    #
#*#*#*#*#*#*#*#*#
#*#*#*#*#*#*#*#*#
#*#*#*#*#*#*#*#*#
#*#*#*#*#*#*#*#*#
#*#*#*#*#*#*#*#f#
#     *****b    #
############### #
#p              #
#################

Meta data:
(Number or Level) (Rows) (Columns)

Info Tiles:
# - Wall
* - Brick
x - Portal

Mobs:
p - Player1
R - Player2
1 - Balloom
2 - Oneal

Powerups:
b - Powerup Bombs
f - Powerup Flames
s - Powerup Speed